NO ./textures/wall.xpm
SO ./textures/wall.xpm
WE ./textures/wall.xpm
EA ./textures/wall.xpm

C 0,0,0
F 42,42,42

1111111111111111111111111111111111111111
1N00000000100000000010000000000000000001
1011111111010111111101011111111111111101
1000000000010000000101000000000000000101
1011111111011111110101111111111111100101
1010000001000000010100000000000010100101
1010111101111111010111111111111010100101
1010100000000001010000000000010010100001
1010101111111101011111111111010010111111
1010101000000101000000000001010010000001
1010101011110101111111111101010011111101
1010001010000100000000000101010000000101
1011111010111111111111100101011111110101
1000000010100000000000100101000000010101
1111111010101111111110100101111111010101
1000000010101000000010100100000000010101
1011111110101011111010100111111111010101
1010000000101010000010100000000001010101
1010111111101010111110111111111101010101
1010100000001010000010000000000101010101
1010101111111011111011111111110101010101
1010101000000000001010000000010101010101
1010101011111111101010111111010101010101
1010100010000000100010100000010101000001
1010111010111110111110101111110101111101
1010000010100C0010000010100000010000D101
1011111010101111110111110101111111110101
1000001010100000010100000101000000010101
1011101010111111010101111101011111010101
1010001010000001010101000001010000010101
1010111011111101010101011111010111110101
1010100000000101010001010000010100000101
1010101111110101111111010111110101111101
1010101000010100000000010100000100000001
1010101011010111111111010101111111111101
101000001001000000C0010001000000000000D1
1011111111111111111111111111111111111101
1000000000000000000000000000000000000001
1111111111111111111111111111111111111111