NO ./textures/wall.xpm
SO ./textures/wall.xpm
WE ./textures/wall.xpm
EA ./textures/wall.xpm

C 0,0,0
F 42,42,42

111111111111111111111111111111
1N0000000010000000000000000001
101111111101011111111111111101
100000000001010000000000000101
101111111101010111111111110101
101000000101010100000000010101
101011110101010101111111010101
101010000101000101000001010101
101010111101111101011101010101
101010100001000001010001010101
101010101111011111010111010101
101000100000010000010100010101
101111101111110111110101110101
100000001000000100000101000101
111111101011111101111101010101
100000001010000001000001010101
101111111010111111011111010101
1010000000101000C0010000010101
1010111111101011111010111110101
1010100000001010000010100000101
1010101111111010111110101111101
1010000000000010000000100000D1
101111111111111111111111111101
100000000000000000000000000001
111111111111111111111111111111