NO ./textures/wall.xpm
SO ./textures/wall.xpm
WE ./textures/wall.xpm
EA ./textures/wall.xpm

C 0,0,0
F 42,42,42

11111111
1N000001
10111101
10000101
11110101
10000101
10111101
10000001
11111111